11111111
1P000C01
10000C01
100E0C01
11111111