1111111111111111111111111111111111111111111111111111111111
1CE0001C0000C0C000000000CCCCCCCCC0000000000CCCCCCCCC000001
1100001C0000C0C000000000CCCCCCCCC0000000000CCCCCCCCC000001
100P001C0000C0C000000000CCCCCCCCC0000000000CCCCCCCCC000001
1000000C0000C0C000000000CCCCCCCCC0000000000CCCCCCCCC000001
1100000C0000C0C000000000CCCCCCCCC0000000000CCCCCCCCC000001
1100000C0000C0C000000000CCCCCCCCC0000000000CCCCCCCCC000001
1100000C0000C0C000000000CCCCCCCCC0000000000CCCCCCCCC000001
1100000C0000C0C000000000CCCCCCCCC0000000000CCCCCCCCC000001
1100000C0000C0C000000000CCCCCCCCC0000000000CCCCCCCCC000001
1100000C0000C0C000000000CCCCCCCCC0000000000CCCCCCCCC000001
1100000C0000C0C000000000CCCCCCCCC0000000000CCCCCCCCC000001
1100000C0000C0C000000000CCCCCCCCC0000000000CCCCCCCCC000001
1100000C0000C0C000000000CCCCCCCCC0000000000CCCCCCCCC000001
1100000C0000C0C000000000CCCCCCCCC0000000000CCCCCCCCC000001
1100000C0000C0C000000000CCCCCCCCC0000000000CCCCCCCCC000001
1100000C0000C0C000000000CCCCCCCCC0000000000CCCCCCCCC000001
1100000C0000C0C000000000CCCCCCCCC0000000000CCCCCCCCC000001
1100000C0000C0C000000000CCCCCCCCC0000000000CCCCCCCCC000001
1100000C0000C0C000000000CCCCCCCCC0000000000CCCCCCCCC000001
1100000C0000C0C000000000CCCCCCCCC0000000000CCCCCCCCC000001
1100000C0000C0C000000000CCCCCCCCC0000000000CCCCCCCCC000001
1100000C0000C0C000000000CCCCCCCCC0000000000CCCCCCCCC000001
1100000C0000C0C000000000CCCCCCCCC0000000000CCCCCCCCC000001
1100000C0000C0C000000000CCCCCCCCC0000000000CCCCCCCCC000001
1100000C0000C0C000000000CCCCCCCCC0000000000CCCCCCCCC000001
1100000C0000C0C000000000CCCCCCCCC0000000000CCCCCCCCC000001
1100000C0000C0C000000000CCCCCCCCC0000000000CCCCCCCCC000001
1100000C0000C0C000000000CCCCCCCCC0000000000CCCCCCCCC000001
1100000C0000C0C000000000CCCCCCCCC0000000000CCCCCCCCC000001
1111111111111111111111111111111111111111111111111111111111