111111111111111111111111111111111111111111
1P00100000000CCCC0000000CCCC00000001100001
10001000CCCC00000010000100CC01110000000001
10001000000001000000000000CC00000001100001
100010000000010000010000010001100000000001
1000001001000100000CCCCC00CC00011000000001
1000CCCC01000100CC001000000000000110000001
10000000CCCCC0100000CCC00000E0000001100001
111111111111111111111111111111111111111111
