111111111111111111111111111111111111111111
1P00100000000CCCC0000000CCCC00000001100001
10001000CCCC00000010000100CC01110000011001
10001111100001000000000000CC00000001100001
1000100C010001000001000011000100001000C001
1000001001000100000CCCCC00CC10011100000001
1000CCCC01000100CC001000010000000100000001
10000000CCCCC0100000CCC01001E1000001100001
111111111111111111111111111111111111111111