111111111111111111111111111111111111111111111111111111111111111111111111111111111111111111111111111111111111111111111111
1PEC00000000000000001000000000000000000000000000000000000000000000000000000000000000000000000000000000000000000000000001
100000000000000000001000100000000000000000000000000000000000000000000000000000000000000000000000000000000000000000000001
1000000000000000000010001000000000000000000000000000000000000000000000000000000CCCCC000000000000000000000000000000000001
100000000000000000001000100000000000000000000000000000000000000000000000000000000000000000000000000000000000000000000001
10000000000000000000100010000000000000000000000000000000000000000000000CCCCCCCCCC000000000000000000000000000000000000001
100000000000000000001000100000000000000000000000000000000000000000000000000000000000000000000000000000000000000000000001
1000000000000000000010001000000000000000000000CCCC0000000011111111111111111111111111000000000000000000000000000000000001
100000000000000000001000100000000000000000000000000000000000000000000000000000000000000000000000000000000000000000000001
100000000000000000001000100000000000000000000000000000000000000000000000000000000100000000000000000000000000000000000001
1000000000000000000000011000000000000000000000000000000000000000000000000000000C010C000000000000000000000000000000000001
1000000000000000000000011000000000CCCCC000000000000000000000000000000000000111111111111100000000000000000000000000000001
100000000000000000000001100000000000000000000000000000000000000000000000000000C001000C0000000000000000000000000000000001
10000000000000000000000110000000000001000000100000000000000000000000000000000000010C000000000000000000000000000000000001
1000000000000000000000011000000000000100000010000000000010000000000000000000000C0100000000000000000000000000000000000001
10000000000000000000000110000000000001000000100000000000100000000000000000000000C10C000000000000000000000000000000000001
100000000000000000000001100000000000010000001000000000001000000000000000000000000000000000000000000000000000000000000001
100000000000000000000001100000000000010000001000000000001000000000000000000000000000000000000000000000000000000000000001
100000000000000000000001100000000000010000001000000000001000000000000000000000111111100000000000000000000000000000000001
100000000000000000000000000000000000010000001000000000001000000000000000000000000000000000000000000000000000000000000001
100000000000000000000000000000000000010000001000000000001000000000000000000000000000000000000000000000000000000000000001
100000000000000000000000000000000000010000001000000000001000000000000000000000000000000000000000000000000000000000000001
100000000000000000000000000000000000000000000000000000001000000000000000000000000000000000000000000000000000000000000001
100000000000000000000000000000000000000000000000000000000000000000000000000000000000000000000000000000000000000000000001
100000000000000000000000000000000000000000000000000000000111111111111111111111111111000000000000000000000000000000000001
100CCC00000000000000C00000000000000000C0000000000000000000000000000000000000000000000000000000000000000000000000CCC00001
100000000000000000000000000000000000000000000000000000000000000000000000000000000000000000000000000000000000000000000001
100000000000000000000000000000000000000000000000000000000000000000000000000000000000000000000000000000000000000000000001
100000000000000000000000000000000000000000000000000000001000000000000000000000000000000000000000000000000000000000000001
100000000000000000000000000000000000000000000000000000001000000000000000000000000000000000000000000000000000000000000001
100000000000000000000000000000000000000000000000000000001000000000000000000000000111000000000000000000000000000000000001
100000000000000000000000000000000000000000000000000000001011111111111111100000000000000000000000000000000000000000000001
100000000000000000000000000000000000000000000000000000001000000000000000000000000000000000000000000000000000000000000001
100000000000000000000000011111111111111110000000000000001000000000000000000000000000000000000000000000000000000000000001
100000000000000000000000000000000000000000000000000000001000000000000000000000000000000000000000000000000000000000000001
100000000000000000000000000000000000000000000000000000001000000000000000000000000000000000000000000000000000000000000001
100000000000000000000000000000000000000000000000000000001000000000000000000000000000000000000000000000000000000000000001
100000000000000000000000000000000000000000000000000000000000000000000000000000000000000000000000000000000000000000000001
100000000000000000000000000000000000000000000000000000000000000000000000000000000000000000000000000000000000000000000001
100000000000000000000000000000000000000000000000000000000000000000000000000000000000000000000000000000000000000000000001
100000000000000000000000000000000000000000000000000000000000000000000000000000000000000000000000000000000000000000000001
100000CCCCCCC00000000000000000000000000000000000000000000000000000000000000000000000000000000000000000000000000000000001
100000000000000000000000000000000000000000000000000000000000000000000000000000000000000000000000000000000000000000000001
100C1100C000111111110000000000000000000000000000000000000000000000000000000001111100000000000000000000000000000000000001
1000000000000CCCCCCC0000000000000000000000000000000000000000000000000000000111000110000000000000000000000000000000000001
10000000000000000000000000000000000000000000000000000000000000000000000000110000001000000000000000000CCCCCCCCCCC00000001
100000000000000000000000000000000000000000000000001111111100000000000000000100000001100000000000000CC00000000000CC000001
100000000000000000000000000000000000000000000000000000000000000000000000000100000001010000000000000CCCCCCCCCCCCCCC000001
10000000000000000000000000000000000000000000000000000000000000000000000000000000000000000000000000000000000C000000000001
10000000000000000000000000000000000000000111111111100000000000000000000000000000000000000000000000000000000C000000000001
10000000000000000000000000111111111111111000000000000000000000011111111111111111100000000000000000000000000C000000000001
10000000000000000000000000000000000000000000000000000000000000000000000000000000011100000000000000000000000C000000000001
10000000000000000000000000000000000000000000000000000000000000000000000000000000000000000000000000000000000C000000000001
1000000000000000000000000000000000000000000000000000000000000000000000000000000000000000000000000000CCCCCCCCCCCCC0000001
100000000000000000000000000000000000000000000000000000000111111111111111111111111111000000000000000000000000000000000001
100000000000000000000000000000000000000000000000000000000000000000000000000000000000000000000000000000000000000000000001
100000000000000000000000000000000000000000000000000000000000000000000000000000000000000000000000000000000000000000000001
100000000000000000000000000000000000000000000000000000000000000000000000000000000000000000000000000000000000000000000001
100000000000000000000000000000000000000000001111111111111111111111111111111111111111000000000000000000000000000000000001
100000000000000000000000000000000000000000000000000000000000000000000000000000000000000000000000000000000000000000000001
100000000000000000000000000000000000000000000000000000000000000000000000000000000000000000000000000000000000000000000001
100000000000000000000000000000000000000000000000000000000000000000000000000000000000000000000000000000000000000000000001
100000000000000000000000000000000000000000000000000000000000000000000000000000000000000000000000000000000000000000000001
100000000000000000000000000000000000000000000000000000000000000000000000000000000000000000000000000000000000000000000001
111111111111111111111111111111111111111111111111111111111111111111111111111111111111111111111111111111111111111111111111