1111111111111111111111111111111111111111111111111
1000000000000000000000010000100100000000000000001
1000000000000000000000001000000010000000000000001
1000000000000000000000010000P00001000000000000001
1000000000000000CCCC00100000000010000000000000001
1000000000000000000001000E00100100000000000000001
1111111111111111111111111111111111111111111111111